{
  "name": "Test Room",
  "width": 20,
  "height": 15,
  "tileSize": 16,
  "tileset": "tileset_test.png",
  "tiles": [
    1,1,1,1,1,1,1,1,1,1,1,1,1,1,1,1,1,1,1,1,
    1,0,0,0,0,0,0,0,0,0,0,0,0,0,0,0,0,0,0,1,
    1,0,0,0,0,0,0,0,0,0,0,0,0,0,0,0,0,0,0,1,
    1,0,0,2,2,2,0,0,0,0,0,0,0,0,2,2,2,0,0,1,
    1,0,0,2,3,2,0,0,0,0,0,0,0,0,2,3,2,0,0,1,
    1,0,0,2,2,2,0,0,0,0,0,0,0,0,2,2,2,0,0,1,
    1,0,0,0,0,0,0,0,0,0,0,0,0,0,0,0,0,0,0,1,
    1,0,0,0,0,0,0,0,0,0,0,0,0,0,0,0,0,0,0,1,
    1,0,0,0,0,0,0,0,0,0,0,0,0,0,0,0,0,0,0,1,
    1,0,0,2,2,2,0,0,0,0,0,0,0,0,2,2,2,0,0,1,
    1,0,0,2,3,2,0,0,0,0,0,0,0,0,2,3,2,0,0,1,
    1,0,0,2,2,2,0,0,0,0,0,0,0,0,2,2,2,0,0,1,
    1,0,0,0,0,0,0,0,0,0,0,0,0,0,0,0,0,0,0,1,
    1,0,0,0,0,0,0,0,0,0,0,0,0,0,0,0,0,0,0,1,
    1,1,1,1,1,1,1,1,1,1,1,1,1,1,1,1,1,1,1,1
  ],
  "collisionTiles": [false, true, true, true],
  "playerStart": {
    "x": 10,
    "y": 7
  }
}